// Posicion inicial x, y (contando desde 0), mapa
5 2
- - - - - - - - - -
- - - - - - F F F -
- - F F F F F - - -
- - F - F - F F - -
- - F - - - - F - -
- - - - - - - F - -
- - - - - - - F - -
- - - - - - - F - -
- - - - - - - - - -
- - - - - - - - - -
